111111111111111111
10000101EC11000001
1000C1010000010C01
10CCC1011110000C01
1000C1011010000001
10P000000000100001
111111111111111111
