111111111111111111
1000000000000111E1
1000C0000000011101
10CCC0000000011101
1000C0000000011101
10P000000000000001
111111111111111111
