111111111111111111
1000000000000111C1
1000C0000000011101
10CCC00000000000E1
1000C0000000011101
10P0000000000111C1
111111111111111111
