111111111111111111
100000000000000001
1000C0000000011101
10CCC00000000111C1
1000C0000000011101
10P0000000000111E1
111111111111111111
