111111111111111111
1P00000000000111E1
1000C0000000000001
111111111111111111

