111111111111111111
10000000E000000001
1000C0000000000001
10CCC0000000000001
1000C0000000000001
10P000000000000001
111111111111111111
