111111111111111111
1000000000000E0001
100000000000000001
100000000000000001
10P000000000000001
111111111111111111