111111111111111111
1000000E010000C001
100C00000100000001
100000000100000001
100P00000100000001
111111111111111111
