111111111111111111
1P00000001000000E1
100C00000100000001
100000000100000001
100000000100000001
111111111111111111
