111111111111111111
10000000000E0001
1000C0000001111111
10P000000000000001
111111111111111111