111111111111111111
1000000000000E0001
1000C0000000000000
1000C0000000000001
10P000000000000001
111111111111111111
