111111111111111111
1P00000E010000C001
100C00000100000001
100000000100000001
100P00000100000001
111111111111111111
