111111111111111111
1000000000000E0001
100C00000000000001
100000000000000001
100000000000000001
111111111111111111