111111111111111111
1P000X0001000000E1
100C00000000000001
10000Y000100000001
100P00000100000001
111111111111111111
