111111111111111111
1P000X0001000000E1
100C00000000000001
10000Y000100000001
100P00000100000001
111111111111111111
111111111111111111
100E000000S0000001
1000C0000000000001
10CCC0000000000001
1000C0000000000001
10P000000000000001
111111111111111111
